#################################################
#                                               #
#         #                           #         #
#    #          #     #               #         #
#         #     #      #            #####       #
#         #     #       #             #         #
#   #######     #        #            #         #
#               #         #                     #
#              #           #                    #
######        #                                 #
#            #                #         #       #
#           #                 #         #       #
#      #####        #         #     #####       #
###                                           ###
###                                           ###
#      #####           #      #####     #       #
#      #         #                      #       #
#      #          #           #         #       #
#      #     #     #          #       #######   #
#      #            #                 #         #
#      #             #                #         #
#      #    #####     #       #            #    #
#                             #########         #
#                         #                     #
#################################################
